222222222222222222222222222222
211111111111111111111111111112
211111111111111111222111111112
222222111111111112212111111112
211112222222211222112222221112
211111111111111221111111111112
221111111111112211111111111112
222112111111122111111111111112
211111111211122111111111111112
211111111111121111111111111112
211111111111221111111111111112
221111111122211111111111111112
222111222211211111111111111112
221111211111211111111111111112
211111111111211111111111111112
211111111112211111111111111112
222111122221111111111111111112
212222221111111111111111111112
211111111111111111111111111112
211111111111111111111111111112
211111111111111111111111111112
211111111111111111111111111112
211111111111111111111111111112
211111111111111111111111111112
211111111111111111111111111112
211111111111111111111111111112
211111111111111111111111111112
211111111111111111111111111112
212222211222222111111111111112
222222222222222222222222222222
